6 6
1 2 3 5 6 7 
3 9 3 4 2 1
1 3 3 3 1 1
1 3 3 3 1 1
1 3 3 3 1 1
1 3 3 3 1 1
6 6
4 6 2 1 4 6
2 3 1 2 4 1
1 3 3 3 1 1
1 3 3 3 1 2
1 3 3 3 4 1
1 3 3 3 4 3
